account for=wyjaśniać coś, podawać powody
act up=źle się zachowywać (o dziecku)
add up=sumować
answer back=odpyskowywać
ask around=rozpytywać
back up=popierać, wspierać kogoś
base on=bazować na, operać się na czymś
be about to=zaraz coś zrobić
be into something=lubić coś, być w coś zaangażowanym
be out=być poza domem
be up to=mieć coś w planie
beat up=pobić kogoś
belong to=należeć do
blend in=wtapiać się w (jakieś tło)
blend into=wtapiać się w (jakieś tło)
boss around=dyrygować kimś, rządzić
break down=popsuć (się)
break out=uciec z więzienia, wybuchnąć (wojna)
break through=przełamać się przez coś, przedrzeć się
break up=zerwać ze sobą
bring back=przywrócić, przynieść z powrotem, oddać
bring together=pogodzić ze sobą, zbliżyć do siebie
bring up=wywchowywać
brush up on=podszlifować, odświeżyć wiedzę
bump into=wpaść na kogoś, spotkać
butt in=wtrącać się, mieszać się do czegoś
call back=oddzwonić
call for=wymagać czegoś, być dobrą okazją do
call off=odwołać
calm down=uspokoić (się)
care for=opiekować się, troszczyć się
carry on=kontynuować
carry out=przeprowadzić, zrealizować
catch up=nadgonić
check in=zameldować się
check out=wymeldować się
check up on <sb>=sprawdzać, kontrolować kogoś
cheer up=poprawić humor
chill out=wyluzuj!
chip in=zrzucać się na coś
close down=zamykać, likwidować (sklep, firmę)
come across=spotkać się z czymś, napotkać
come back=wracać
come from=pochodzić skądś
come in=wejść
come out=wyjść na jaw, okazać się
come round=odwiedzić kogoś przy okazji
come up with=wymyśleć coś
count on=liczyć na (kogoś)
cut down on <sth>=ograniczyć (spożycie)
cut off=odciąć
cut <sth> out=przestać, wyciąć
deal with=radzić sobie (z jakąś sytuacją)
depend on=zależeć od
die out=wymierać
do over=zrobić od nowa
do up=zapiąć (guziki)
do without=obejść się bez czegoś
drag away=odciągać, odwlekać
drink up=wypić do dna
drop by=odwiedzić kogoś przy okazji
drop off=wysadzić kogoś (z auta)
drop out=zrezygnować, rzucić (szkołę)
eat out=zjeść na mieście
end up=skończyć gdzieś, wylądować
face up to=stawić czemuś czoła
fade away=zanikać, blednąć
fall apart=rozpadać się
fall behind=zostawać z tyłu (z postępami w pracy)
fall down=spadać
fall for=zakochać się w kimś
fall off=odpaść
fall out with <sb>=pokłócić się z kimś (bliskim)
feel for <sb>=współczuć komuś
figure out=rozkminić, zorientować się, zrozumieć
fill in=wypełnić po brzeg
fill up=nalać po brzeg
fill out=wypełnić (formularz)
find out <sth>=odkryć, zorientować się
fit in=wpasować, dopasować (się)
get away with=wywinąć się, uniknąć odpowiedzialności (za morderstwo)
get back=wracać
get down to=zabrać się za coś
get on <the bus>=wsiadać do autobusu
get in <the car>=wsiadać do samochodu
get off=wysiadać
get on well with <sb>=mieć z kimś dobre relacje
get over=przejść do porządku dziennego, pogodzić się z czymś / znaleźć rozwiązanie
get rid of <sth>=pozbyć się czegoś
get <sb> down=dołować kogoś
get together=spotkać się całą grupą
get up=wstawać / budzić się
give back=oddawać
give in to <sb/sth>=poddawać się, ulegać (komuś/czemuś)
give <sb> away=wydać, zdradzić kogoś
give up=poddać się, zrezygnować
go ahead=zacząć (przed kimś innym)
go away=wyjeżdżać
go back=wracać
go by=mijać (o czasie) / przechodzić obok
go down=spadać, obniżać się / zatonąć
go in=wejść
go off=wybuchnąć (bomba)
go on=kontynuować
go out=chodzić ze sobą / wychodzić / gasnąć
go with <sth>=dobrze smakować z czymś / iść z kimś
grow apart=oddalać się od siebie (w relacji)
grow up=dorastać
hand in=wręczyć coś
hand out=rozdać, dystrybuować coś ręcznie
hang on=czekać, poczekaj
hang out=miło i bezproduktywnie spędzać wspólnie czas
hang up=odłożyć słuchawkę telefonu
hit it off=szybko się zaprzyjaźnić
hold back=zatrzymywać, powstrzymywać
hold on=zaczekać, powstrzymać się
hurry up=pospiesz się
jump in=wtrącić się do rozmowy, wskoczyć
keep away from=trzymać z dala od (dzieci)
keep on=kontynuować pracę
kick back=relaksować się
kick off=zacząć mecz / zrzucić buty kopniakiem ze stóp
kick out=wykopać, pozbyć się
knock down=powalić, potrącić autem
lay off=zwolnić (pracowników)
let down=zawieść kogoś, rozczarować
let out=wypuścić kogoś na zewnątrz / coś z siebie
lie down=położyć (się)
live up to=sprostać (wyzwaniu, ideałom)
log in on=logować się
log out off=wylogować się
look after=dbać, zajmować się kimś
look around=rozglądać się
look down on=patrzeć na kogoś z góry z pogardą
look up to <sb>=inspirować się kimś
look for=szukać
look forward to=cieszyć się na coś
look into=badać sprawę
look out=uważać na niebezpieczeństwo
make for=iść w jakimś kierunku
make up=wymyślić coś
make up for=nadrabiać, rekompensować
mess up=popełnić błąd
mess with <sb>=zadzierać z kimś
move in=wprowadzić się do mieszkania
move out=wyprowadzić się z mieszkania
move on to=przejść do czegoś (kolejnego punktu spotkania)
nail down=ustalić, dograć szczegóły / zmusić kogoś, przycisnąć
narrow down=zawęzić
nod off=przysnąć sobie
nose about=węszyć, szukać
opt for <sth>=optować za czymś
opt to do <sth>=zdecydować się coś zrobić
pass away=umrzeć
pass on=przekazać informację
pass out=zemdleć
pay back=oddać dług
pay off=spłacić
pick up=podnieść z ziemi, odebrać kogoś autem
pin down=przyszpilić
piss off=wkurzać kogoś
plug in=podłączyć wtyczkę
point out=wskazywać na, uzmysławiać
print out=wydrukować
pull back=wycofywać się
pull down=zburzyć
pull over=zatrzymać auto na poboczu
put back=odłożyć na miejsce / cofnąć wskazówki zegara
put down=kłaść / zapisywać / upokarzać
put forward=zaproponować przesunąc wskazówkę zegara do przodu, nominować
put on=zakładać, ubierać
put out=zgasić
put <sth> off=przełożyć na później
put up with=znosić, tolerować
ring back=oddzwonić
rip <sb> off=domagać się zawyżonej ceny, zdzierać
round up=zaokrąglać w górę
round down=zaokrąglać w dół
rule <sth> out=wykluczyć coś (jakąś możliwość)
run away=uciec
run into=spotkać kogoś przypadkiem, natrafić
run out=nie mieć już czegoś, co potrzebujemy, skończyć się
run over=przejechać, potrącić coś / kogoś
screw up=schrzanić, zepsuć
sell out=wyprzedać, sprzedać się
set off=wyruszyć w drogę
set on doing <sth>=postanowić coś zrobić
set up=zorganizować, zaplanować
settle down=osiąść, dogadać cenę
show around=oprowadzić kogoś po miejscu
show off=chwalić się, popisywać
show up=pojawić się gdzieś
shut up=przestać mówić
sleep in=pospać dłużej niż zwykle, wyspać się
slow down=zwolnić (poruszać się wolniej)
speak up=powiedzieć głośno / głośniej
speed <sth> up=(coś) przyspieszyć
stand back=odsunąć się
stand down=ustąpić ze stanowiska
stand out <from>=być łatwo zauważalnym, odstawać
stand up to=przeciwstawiać się czemuś, postawić się
start over=zacząć od nowa
stay away from=trzymać się z daleka od kogoś / czegoś
stay behind with=zostawać w tyle (z czymś)
stay in=zostać w (domu)
stay out=nie wracać do (domu)
stay out of <sth>=nie mieszać się do konfliktu, trzymac się z dala od czegoś złego
sleep over=zostać na noc
stay up=nie kłaść się spać
stick to <the plan>=trzymać się czegoś
stock up=zaopatrzyć się
sum up=podsumować, reasumować
switch on=włączyć (s..)
switch off=wyłączyć (s..)
take aback=zaskoczyć
take after=przypominać kogoś z rodziny
take back=zwracać, cofnąć co się powiedziało
take down=zanotować
take off=wystartować (samolot), obniżyć cenę, zdjąć ubranie
take on=zatrudniać, przyjmować (intake = nabór)
take out=wyjąć, usunąć (zęba)
take over=przejąć kontrolę
take to=polubić
talk into=namówić kogoś, przekonać do czegoś
tell apart=widzieć różnicę, odróżniać
tell off=ochrzanić kogoś
think <sth> over=przemyśleć coś
throw away=wyrzucić
throw in=dorzucić dodatkowo, wrzucić
tie up=być związanym, zbyt zajętym na cokolwiek innego
touch down=wylądować (samolot)
try on=przymierzyć
try out=wypróbować
turn away=odmówić, odtrącić
turn down=obniżyć, zmniejszyć, odmówić
turn on=włączyć
turn off=wyłączyć (t..)
turn out=okazać się (t..)
turn up=pojawić się, przyjść
wait out=przeczekać
wake up=(o)budzić się
warm up=rozgrzewać (się)
wash up=zmywać
watch out=uważać, strzec się
wind down=rozluźniać się, spuszczać parę
work on=pracować nad czymś
work out=ćwiczyć na siłowni / znaleźć rozwiązanie problemu
wrap up=podsumować, reasumować
write down=zapisać
zip up=zapiąć zamek błyskawiczny
zoom in=przybliżyć w obiektywie
zoom out=oddalić w obiektywie
